32
32
55555555555555555555555555555555
55555555555555555555555555555555
55555555555555555555555555555555
55555555555555555555555555555555
55553333333333333333333333335555
55553333333333333333333333335555
55553333333333333333333333335555
55553333333333333333333333335555
55553333324678910333333333335555
55553333333333333333333333335555
55553333333333333333333333335555
55553333333333333333333333335555
55553333333333333333333333335555
55553333333333333333333333335555
55553333333333333333333333335555
55553333333333333333333333335555
55553333333333333333333333335555
55553333333333333333333333335555
55553333333333333333333333335555
55553333333333333333333333335555
55553333333333333333333333335555
55553333333333333333333333335555
55553333333333333333333333335555
55553333333333333333333333335555
55553333333333333333333333335555
55553333333333333333333333335555
55553333333333333333333333335555
55553333333333333333333333335555
55555555555555555555555555555555
55555555555555555555555555555555
55555555555555555555555555555555
55555555555555555555555555555555
