29
29
555555555555555555555555555555
555555555555555555555555555555
555555555555555555555555555555
555500000000000000000000005555
555500000000000000000000005555
555500000000000000000000005555
555500000000000000000000005555
555500000000000000000000005555
555500000000000000000000005555
555500000000000000000000005555
555500000000000000000000005555
555500000000000000000000005555
555500000000000000000000005555
555500000000004370000000005555
555500000000004370000000005555
555500000000004370000000005555
555500000000004370000000005555
555500000000000000000000005555
555500000000000000000000005555
555500000000000000000000005555
555500000000000000000000005555
555500000000000000000000005555
555500000000000000000000005555
555500000000000000000000005555
555500000000000000000000005555
555500000000000000000000005555
555500000000000000000000005555
555555555555555555555555555555
555555555555555555555555555555
