29
29
111111111111111111111111111111
111111111111111111111111111111
111111111111111111111111111111
111100000000000000000000001111
111100000000000000000000001111
111100000000000000000000001111
111100000000000000000000001111
111100000000000000000000001111
111100000000000000000000001111
111100000000000000000000001111
111100000000000000000000001111
111100000000000000000000001111
111100000000000000000000001111
111111111111154361111111111111
111111111111154361111111111111
111111111111154361111111111111
111111111111154361111111111111
111100000000000000000000001111
111100000000000000000000001111
111100000000000000000000001111
111100000000000000000000001111
111100000000000000000000001111
111100000000000000000000001111
111100000000000000000000001111
111100000000000000000000001111
111100000000000000000000001111
111100000000000000000000001111
111111111111111111111111111111
111111111111111111111111111111
